// 30x30 empty map (15m x 15m). Cells are 0.5m. '#' = obstacle, 'L' = leader spawn, 'F' = follower spawn.
##############################
#............................#
#............................#
#............................#
#............................#
#.....L.....F................#
#............................#
#............................#
#............................#
#............................#
#............................#
#............................#
#............................#
#............................#
#............................#
#............................#
#............................#
#............................#
#............................#
#............................#
#............................#
#............................#
#............................#
#............................#
#............................#
#............................#
#............................#
#............................#
#............................#
##############################
